00000000000000000000000000000000000000000000000000000000000000000000000000000000
00000000000000000000000000000000000000000000000000000000000000000000000000000000
00000000000000000000000000000000000000000000000000000000000000000000000000000000
00000000000000000000000000000000000000000000000000000000000000000000000000000000
00000000000001100000000000000000000000000000000000000000000000000000001110000000
00000000000000011000000000000000000000000000000000000000000000000000011000000000
00000000000000001100000000000000000000000000000000000000000000000001100000000000
00000000000000000100000000000000000000000000000000000000000000000110000000000000
00000000000000000001000000000000000000000000000000000000000000011000000000000000
00000000000000000000000000000000000100000000000000000000000001000000000000000000
00000000000000000000001000000000001100000000000000000000000110000000000000000000
00000000000000000000000010000000011110000000000000000000101000000000000000000000
00000000000000000000000000010000110011000000000000000010000000000000000000000000
00000000000000000000000000000001100001100000000000011000000000000000000000000000
00000000000000000000000000000110000000110000000001000000000000000000000000000000
00000000000000000000000000001100100000011100101000000000000000000000000000000000
00000000000000000000000000111111111111111110000000000000000000000000000000000000
00000000000000000000000000111100000101001110000000000000000000000000000000000000
00000000000000000000000000100110001101110010000000000000000000000000000000000000
00000000000000000000000000100011101011010010000000000000000000000000000000000000
00000000000000000000000000110000011100000110000000000000000000000000000000000000
00000000000000000000000001100000011110000011000000000000000000000000000000000000
00000000000000000000101000100000110101100001000000000000000000000000000000000000
00000000000000000111000000100011000100110001110000000000000000000000000000000000
00000000000000011100000000101110000100011101001000000000000000000000000000000000
00000000000000110000000000111000000100000111001100000000000000000000000000000000
00000000000001100000000000111111111111111111000100000000000000000000000000000000
00000000000000000000000000000000000000000000000011000000000000000000000000000000
00000000000000000000000000000000000000000000000000100000000000000000000000000000
00000000000000000000000000000000000000000000000000011000000000000000000000000000
00000000000000000000000000000000000000000000000000000100000000000000000000000000
00000000000000000000000000000000000000000000000000000000000000000000000000000000
00000000000000000000000000000000000000000000000000000000000000000000000000000000
00000000000000000000000000000000000000000000000000000000000000000000000000000000
00000000000000000000000000000000000000000000000000000000000000000000000000000000
00000000000000000000000000000000000000000000000000000000000000000000000000000000
00000000000000000000000000000000000000000000000000000000000000000000000000000000
00000000000000000000000000000000000000000000000000000000000000000000000000000000
00000000000000000000000000000000000000000000000000000000000000000000000000000000
00000000000000000000000000000000000000000000000000000000000000000000000000000000