1111111111111111111111111111111111111111111111111111111111111111111111
1000000000000000000000000000000000000000000000000000000000020333333001
1000000000000000000202202200002000000000000000000230330333333000000001
1000000000002101010010001002100001000103313013031010010101121111100001
1002000110110000000000000000030333333330000200200020020000000100011001
1000001100000220000003033030302200200002000202220002000202220100010001
1000001000000003303300002002220222222000220202022200200000020100010001
1000001003333330000002222222222202002002200022222202200000220122210001
1000011330002000002222020000002222200222202220202222022202020100100001
1000013300000222222002222220000022022022222222222222222202221122100001
1000013000002022200022000002020002222222222222202222222222221000100001
1000013000200220000022200202220222022222202202022222220222001000100001
1000013022022000000022222222200220022222020222222022222220001000100001
1020213202222000200002022020222022202022220222002222022000001001100001
1000031202022220200202202202222222222222222222020222220020001001000001
1000031220000222020022220202220222022200002022222220000020011001000001
1000031222200020000200022202020222220222222222222020220020010001000001
1000301002202002222022200222000222222220000000020022222200010001000001
1020301002200000222000200222022202020000202222200022000000010001000001
1000301000020000002020000200200200222220200220020000000000010001000001
1000301000002200000200200202000200000000002000000000000033010001000001
1000010000000020202022200200000200000200000000000003333300010001000001
1000110000020000220000020000000000000000000003333330000000100001000001
1001103000002220002000000000000000000000033330000000000000100011000001
1011003300000000000000000000000000003333300000000000000001101110000001
1100000333000000000000000000033333330000000000000000001011000000000001
1000000003333300000333333333300000000000000001010010000000000000000001
1000000000000333333000000000000000000011000000000000000000000000000001
1000000000000000000001000000101000000000000000000000000000000000000001
1111111111111111111111111111111111111111111111111111111111111111111111
