1111111111111111111111111111111111111111111111111111111111111111111111
1000000000000000000000000000000000000000000001000100011100000000000001
1000000000000000000000000000000000000000010000000000000111000000000001
1000000000000000000000000000000000100000000000000000000001000000000001
1000000000000000000000000000000000000000000000000000000001000000000001
1000000000000000000000000000111111000000000000000000000001000000000001
1000000000000000000000000111000101111111011000000000000001000000000001
1000000000000000001101011000110000000110000111100000000010000000000001
1000000000000000011111100000000000001101001001111110000110000000101011
1000000000000011110011100100001000100100110000100001100000000010000001
1000000001111100000110110000000000000110001000010000111000100000000001
1000000111001000011100000100000000000010000100010001011000000000000001
1000001001010001111000000001000000000010000100010110011000000000000001
1000010000110010100000000000110000000010000100010000001000000000000001
1001100001001101100000000000011000000010001101111000001000000000000001
1010000001010010000000000000000100000100011000100000001000000000000001
1110000001100010000000000000000110011001100100100000001000000000000001
1100000011001100000000000000000001111110010001000000001000000000000001
1000000011101000000000000000000110000111100110000000011000000000000001
1100000100110000000000000001010000000000001000000000010000000000000001
1100000100110100000000010100000000000000100000000010100000000000000001
1110000101000010010001000000000000000010000000001000000000000000000001
1011011110010010100000000000000000001000000000100000000000000000000001
1000000100000000001000000000000100100000000100000000000000000000000001
1000000000000000000010101011001010000100000000000000000000000000000001
1100000100000100000100000100000000000000000000000000000000000000000001
1000000000000000000000000000000000000000000000000000000000000000000001
1000000000000000000000000000000000000000000000000000000000000000000001
1000000000000000000000000000000000000000000000000000000000000000000001
1111111111111111111111111111111111111111111111111111111111111111111111
