1111111111111111111111111111111111111111111111111111111111111111111111
1000000000000000000000000000000000000000000000000010000000000000000001
1000000000000000000000000000000000000000000000000010000000000000000001
1000000000000000000000000000000000000000000000000010000000000000000001
1000000000000000000000000000000000000000000000000010000000000000000001
1000000000000000000000000000000000000000000000110010000000000000000001
1000000000000000000000000000000000000000001111000010000000000000000001
1000000000000000000000000000000000000011110000000010000000000000000001
1000000000000000000000000000000000011110000000000010000000110000000001
1000000000000000000000000000000011110000000000000010000011100000000001
1000000000000000000000000000001110000000000000000011111111111111111111
1000000000000000000000000000111000000000000000000000011000000003000001
1000000000000000000000000000000000000000000000000000110000000033000001
1000000000000000000000000000000000000000000000000001100000000300000001
1000000000000000000000000000000000000000000000000011000000003000000001
1000000000000000000000000000000000000000000000000000000000030000000001
1000000000000000000000000000000000000000000000000000000000030000000001
1000000000000000000000000000000000000000000000000000000000300000000001
1000000000000000000000000000022222222222220000000002220003300000000001
1000000000000000000000000000000000000000002222222222000003000000000001
1000000000000000000000000000000000000000000000000000000033000000000001
1000000000000000000000000000000000000000000000000000000030000000000001
1000000000000000000000000000000000000000000000000000000000000000000001
1000000000000000000000000000000000000000000000000000000000000000000001
1000000000000000000000000000000000000000000000000000000000000000000001
1000000000000000000000000000000000000000000000000000000000000000000001
1000000000000000000000000000000000000000000000000000000000000000000001
1000000000000000000000000000000000000000000000000000000000000000000001
1000000000000000000000000000000000000000000000000000000000000000000001
1111111111111111111111111111111111111111111111111111111111111111111111
