11110000000000000000000000000000000000000000000000000000000000000000000111111111
00000000000000000000000000000000000000000000000000000000000000000000000000000000
00000000000000000000000000000000000000000000000000000000000000000000000000000000
00000000000000000000000000000000000000000000000000000000000000000000000000000000
00001000000000000000000000000000000000000000000000000000000000000000000100000000
00000100000000000000000000000000000000000000000000000000000000000000001000000000
00000010000000000000000000000000000000000000000000000000000000000000010000000000
00000001000000111111111111111111110000100001111111111111111111100000100000000000
00000000100000100000000000000000000000100000000000000000000000100001000000000000
00000000010000100000000000000000000000100000000000000000000000100010000000000000
00000000001000100000000000000000000000100000000000000000000000100100000000000000
00000000000100100000000000000000000000100000000000000000000000101000000000000000
00000000000011100000000000000000000000100000000000000000000000110000000000000000
00000000000000000000000000000000000000100000000000000000000000000000000000000000
00000000000000000000000000000000000000100000000000000000000000000000000000000000
00000000000000000000000000000000000000000000000000000000000000000000000000000000
00000000000000000000000000000000000000000000000000000000000000000000000000000000
00000000000000000000000000000000000000000000000000000000000000000000000000000000
00000000000000000000000000000000000000000000000000000000000000000000000000000000
00000000000000000000000000000000000000100000000000000000000000000000000000000000
00000000000000000000000000000000000000100000000000000000000000000000000000000000
00000000000000000000000000000000000000100000000000000000000000000000000000000000
00000000000000000000000000000000000000100000000000000000000000000000000000000000
00000000000000000000000000000000000000100000000000000000000000000000000000000000
00000000000000000000000000000000000000100000000000000000000000000000000000000000
00000000000000000000000000000000000000100000000000000000000000000000000000000000
00000000000001111111111111111111110000100001111111111111111111110000000000000000
00000000000010100000000000000000000000100000000000000000000000101000000000000000
00000000000100100000000000000000000000100000000000000000000000100100000000000000
00000000001000100000000000000000000000100000000000000000000000100010000000000000
00000000010000100000000000000000000000100000000000000000000000100001000000000000
00000000100000100000000000000000000000100000000000000000000000100000100000000000
00000001000000000000000000000000000000000000000000000000000000000000010000000000
00000010000000000000000000000000000000000000000000000000000000000000001000000000
00000100000000000000000000000000000000000000000000000000000000000000000100000000
00001000000000000000000000000000000000000000000000000000000000000000000010000000
0000000000000000000000000000000000000000000000000000000000000000000000000000000
00000000000000000000000000000000000000000000000000000000000000000000000000000000
00000000000000000000000000000000000000000000000000000000000000000000000000000000
11110000000000000000000000000000000000000000000000000000000000000000000011111111