01000000000010000000000000000000000000000000000000000100000000000000000000000010
01000000000010000000000000000000000000000000000000000100000000000000000000000010
11000000000011111111111111111111111111111111111111111100000000000000000000000011
00000000000000000000000000000000000000000000000000000000000000000000000000000000
00000000000000000000000000000000000000000000000000000000000000000000000000000000
00000000000000000000000000000000000000000000000000000000000000000000000000000000
00000000000001000000000000000000000000000000000000000100000000000000000000000000
00000000000001000000000000000000000000000000000000001000000000000000000000000000
00000000000001000000000000000000000000000000000000001000000000000000000000000000
00000000000001000000000000000000000000000000000000001000000000000000000000000000
00000000000001000000000000000000000000000000000000001000000000000000000000000000
00000000000001100000000000000000000000000000000000011000000000000000000000000000
00000000000000100000000000000000000000000000000000010000000000000000000000000000
00000000000000100000000000000000000000000000000000010000000000000000000000000000
00000000000000110000000000000000000000000000000000010000000000000000000000000000
00000000000000010000000000000000000000000000000000110000000001000000001000000000
00000000000000010000000000000000000000000000000000100000000000100000010000000000
00000000000000010000000000000000000000000000000000100000000000010000100000000000
00000000000000011000000000000000000000000000000001100000000000001001000000000000
00000000000000001000000000000000000000000000000001000000000000000110000000000000
00000000000000001000000000000000000000000000000001000000000000001001000000000000
00000000000000001000000000000000000000000000000001000000000000010000100000000000
00000000000000001111111111111111111111111111111110000000000000100000010000000000
00000000000000001000000000000000000000000000000010000000000001000000001000000000
00000000000000000100000000000000000000000000000100000000000000000000000000000000
00000000000000000010000000000000000000000000001000000000000000000000000000000000
00000000000000000001000000000000000000000000010000000000000000000000000000000000
00000000000000000000100000000000000000000000100000000000000000000000000000000000
00000000000000000000010000000000000000000001000000000000000000000000000000000000
00000000000000000000001000000000000000000010000000000000000000000000000000000000
00000000000000000000000100000000000000000100000000000000000000000000000000000000
00000000000000000000000010000000000000001000000000000000000000000000000000000000
00000000000000000000000001000000000000010000000000000000000000000000000000000000
00000000000000000000000000100000000000100000000000000000000000000000000000000000
00000000000000000000000000010000000001000000000000000000000000000000000000000000
00000000000000000000000000001000000010000000000000000000000000000000000000000000
00000000000000000000000000000100000100000000000000000000000000000000000000000000
11000000000000000000000000000010001000000000000000000000000000000000000000000011
01000000000000000000000000000001010000000000000000000000000000000000000000000010
01000000000000000000000000000000100000000000000000000000000000000000000000000010