01000000000000000000000000000000000000000000000000000000000000000000000000000010
01000000000000000000000000000000000000000000000000000000000000000000000000000010
11000000000000000000000000000000000001001000000000000000000000000000000000000011
00000011111111000000000000000000000001001000000000000000000000001111111100000000
00000010000000000000000000000000000001001000000000000000000000000000000100000000
00000010000000000000000000000000000001001000000000000000000000000000000100000000
00000010000000000000000000000000000001001000000000000000000000000000000100000000
00000010000000000000011000110000000000000000000000000000001100001100000100000000
00000000000000000000000100000000000000000000000000000000000000010000000000000000
00000000000000000000000101000000000000000000000000000000000010010000000000000000
00000000000000000000000100000000000000000000000000000000000000010000000000000000
00000000000000000000000000111111111100000001111111110000000000000000000000000000
00000000000000000000000000100000000000000000000000010000000000000000000000000000
00000000000000000000000000100000000000000000000000010000000000000000000000000000
00000000000000000000000000100000000000000000000000010000000000000000000000000000
00000000000000000000000000100000000000000000000000010000000000000000000000000000
11111111111110000000000000000000000000000000000000000000000001111111111111111111
00000000000000000000000000000000000000000000000000000000000000000000000000000000
00000000000000000000000000000000000000000000000000000000000000000000000000000000
11111111111110000000000000000000000000000000000000000000000001111111111111111111
00000000000000000000000000100000000000000000000000010000000000000000000000000000
00000000000000000000000000100000000000000000000000010000000000000000000000000000
00000000000000000000000000100000000000000000000000010000000000000000000000000000
00000000000000000000000000100000000000000000000000010000000000000000000000000000
00000000000000000000000000100000000000000000000000010000000000000000000000000000
00000000000000000000000000111111111100000001111111110000000000000000000000000000
00000000000000000000000000000000000000000000000000000000000000000000000000000000
00000000000000000000000000000000000000000000000000000000000000000000000000000000
00000000000000000000110001100000000000000000000000000000011000110000000000000000
00000010000000000000001000100000000000000000000000000000000100100000000100000000
00000010000000000000001010000000000000000000000000000000000101000000000100000000
00000010000000000000001000100000000000000000000000000000000100100000000100000000
00000010000000000000000000000000000000000000000000000000000000000000000100000000
00000011111111100000000000000000000100000100000000000000000000111111111100000000
00000000000000000000000000000000000100000100000000000000000000000000000000000000
00000000000000000000000000000000000100000100000000000000000000000000000000000000
00000000000000000000000000000000000100000100000000000000000000000000000000000000
11000000000000000000000000000000000000000000000000000000000000000000000000000011
01000000000000000000000000000000000000000000000000000000000000000000000000000010
01000000000000000000000000000000000000000000000000000000000000000000000000000010