01000000000000000000000000000000000001100000000000000000000000000000000000000010
01000000000000000000000000000000000011110000000000000000000000000000000000000010
11000000000000000000000000000000000111111000000000000000000000000000000000000011
00000000000000000000000000000000001111111100000000000000000000000000000000000000
00000000000000000000000000000000011111111110000000000000000000000000000000000000
00000000000000000000000000000000111111111111000000000000000000000000000000000000
00000000000000000000000000000001111111111111100000000000000000000000000000000000
00000001111111111000000000000011111111111111110000000000001111111111111100000000
00000001000000000000000000000111111111111111111000000000000000000000000100000000
00000001000000000000000000001111111111111111111100000000000000000000000100000000
00000001000000000000000000011111111111111111111110000000000000000000000100000000
00000001000000000000000000111111111111111111111111000000000000000000000100000000
00000001000000000000000001111111111111111111111111100000000000000000000100000000
00000001000000000000000011111111111111111111111111110000000000000000000100000000
00000001000000000000000111111111111111111111111111111000000000000000000100000000
00000001000000000000001111111111111111111111111111111100000000000000000100000000
00000001000000000000011111111111111111111111111111111110000000000000000100000000
00000001100000000000111111111111111111111111111111111111000000000000000100000000
00000000100000000001000000000000000000000000000000000000010000000000000100000000
00000000100000000001000000000000000000000000000000000000010000000000000100000000
00000000100000000001000000000000000000000000000000000000010000000000000100000000
00000000100000000001000000000000000000000000000000000000010000000000000100000000
00000000100000000001000000000000000000000000000000000000010000000000000100000000
00000000100000000001000000000000000000000000000000000000010000000000000100000000
00000000100000000001000000000000000000000000000000000000010000000000000100000000
00000000100000000001000000000000000000000000000000000000010000000000000100000000
00000000100000000001000000000000000000000000000000000000010000000000000100000000
00000000000000000000000000000000000000000000000000000000000000000000000000000000
00000000000000000000000000000000000000000000000000000000000000000000000000000000
00000000000000000000000001111111111111111111111111000000000000000000000000000000
00000000000000000000000000000000000000000000000000000000000000000000000000000000
00000000000000000000000000000000000000000000000000000000000000000000000000000000
00000000000000000000000000000000000000000000000000000000000000000000000000000000
00000000100000000001000000000000000000000000000000000000010000000000000000000000
00000000100000000001000000000000000000000000000000000000010000000000000000000000
00000000100000000001000000000000000000000000000000000000010000000000000000000000
00000000100000000001000000000000000000000000000000000000010000000000000000000000
11000000100000000001000000000000000000000000000000000000010000000000000000000011
01000000100000000001000000000000000000000000000000000000010000000000000000000010
01000000100000000001000000000000000000000000000000000000010000000000000000000010