00000000000000000000000000000000000000000000000000000000000000000000000000000000
00000000000000000000000000000000000000000000000000000000000000000000000000000000
00000000000000000000000000000000000000000000000000000000000000000000000000000000
00000000000000000000000000000000000000000000000000000000000000000000000000000000
00000000000000000000000000000000000000000000000000000000000000000000000000000000
00000000000000000000000000000000000000000000000000000000000000000000000000000000
00000000000000000000000000000000000000000000000000000000000000000000000000000000
00000000000000111111111111111111111000000000000111111111111111111110000000000000
00000000000000100000000000000000000000000000001000000000000000000000000000000000
00000000000000100000000000000000000000000000010000000000000000000000000000000000
00000000000000100000000000000000000000000000100000000000000000000000000000000000
00000000000000100000000000000000000000000001000000000000000000000000000000000000
00000000000000100000000000000000000000000010000000000000000000000000000000000000
00000000000000000000000000000000000000000100000000000000000000000000000000000000
00000000000000000000000000000000000000001000000000000000000000000000000000000000
00000000000000000000000000000000000000010000000000000000000000000000000000000000
00000000000000000000000000000000000000100000000000000000000000000000000000000000
00000000000000000000000000000000000001000000000000000000000000000000000000000000
00000000000000000001111111111111111111111111110000000000000000000000000000000000
00000000000000000000000000001000000000000000000000000000000000000000000000000000
00000000000000000000000000010000000000000000000000010000001000000000000000000000
00000000000000000000000000100000000000000000000000001000010000000000000000000000
00000000000000000000000001000000000000000000000000000100100000000000000000000000
00000000000000000000000010000000000000000000000111111100111111100000000000000000
00000000000000000000000100000000000000000000000000000100100000000000000000000000
00000000000000000000001000000000000000000000000000001000010000000000000000000000
00000000000000000000010000000000000000000000000000010000001000000001000000000000
00000000000000000000100000000000000000000000000000000000000000000001000000000000
00000000000000000001000000000000000000000000000000000000000000000001000000000000
00000000000000000010000000000000000000000000000000000000000000000001000000000000
00000000000000000100000000000000000000000000000000000000000000000001000000000000
11111111111111111100000000000000000000000000000000011111111111111111100000000000
00000000000000000000000000000000000000000000000000000000000000000000000000000000
00000000000000000000000000000000000000000000000000000000000000000000000000000000
00000000000000000000000000000000000000000000000000000000000000000000000000000000
00000000000000000000000000000000000000000000000000000000000000000000000000000000
00000000000000000000000000000000000000000000000000000000000000000000000000000000
00000000000000000000000000000000000000000000000000000000000000000000000000000000
00000000000000000000000000000000000000000000000000000000000000000000000000000000
00000000000000000000000000000000000000000000000000000000000000000000000000000000