00000000000000000000000000000000000111111111111111111111000000000000000000000000
00000000000000001111111111111111111100000000000000000001111100000000000000000000
00000000000111111000000000000000000000000000000000000000000111111111000000000000
00000011111100000000000000000000000000000000000000000000000000000001111111000000
00000110000000000000000000000000000000000000000000000000000000000000000000000000
00000000011111111111000000000000000000000000000000000000000000011111111111000000
00000000000000000000000000000000000000000000000000000000000000000000000000000000
00000000000000000000000000000000000000010000000000000000000000000000000000000000
00000000000000000000000000000000000000010000000000000000000000000000000000000000
00000000000000000000000000000000000000010000000000000000000000000000000000000000
00100000000000000000000000000000000000010000000000000000000000000000000000110000
00111000000000000000000000000000000000010000000000000000000000000000000001100000
00001100000000000000000000000000000000010000000000000000000000000000000011000000
00000110000000000000000000000000000000010000000000000000000000000000000110000000
00000011000000000000000000000000000000010000000000000000000000000000001100000000
00000001100000000000000000000000000000010000000000000000000000000000011000000000
00000000110000000000000000000000000000010000000000000000000000000000110000000000
00000000011000000000000000000000000000010000000000000000000000000000100000000000
00000000001100000000000000000000000000010000000000000000000000000011000000000000
00000000000011000000000000000000000000010000000000000000000000000010000000000000
00000000000001100000000000000000000000010000000000000000000000001100000000000000
00000000000000100000000000000000000000010000000000000000000000011000000000000000
00000000000000110000000000000000000000010000000000000000000000110000000000000000
00000000000000011100000000000000000000110000000000000000000001100000000000000000
00000000000000000110000000000000000000000000000000000000000011000000000000000000
00000000000000000000000000000000000000000000000000000000000110000000000000000000
00000000000000000000011110000000000000000000000000000000111000000000000000000000
00000000000000000000000111111111111111111111111111111111100000000000000000000000
00000000000000000000000000000000000000000000000000000000000000000000000000000000
00000000000000000000000000000000000000000000000000000000000000000000000000000000
00000000000110000000000000000000000000000000000000000000000000000001100000000000
00000000000011110000000000000000000000000000000000000000000000000011000000000000
00000000000000011110000000000000000000000000000000000000000000000110000000000000
00000000000000000011100000000000000000000000000000000000000000001100000000000000
00000000000000000000011100000000000000000000000000000000000000011000000000000000
00000000000000000000000111110000000000000000000000000000000001110000000000000000
00000000000000000000000000011111111000000000000000000000000111000000000000000000
00000000000000000000000000000000001111111111110000000001111100000000000000000000
00000000000000000000000000000000000000000000011111111110000000000000000000000000
00000000000000000000000000000000000000000000000000000000000000000000000000000000